0000001010
000000111A
0000001010
0303000000
C333000000
03030B0000
0002222200
0000020000
0000020000
0002222200