00B0000000
2222200000
0020000000
2222200000
0303000000
C333000000
0303001110
0000000100
0000011111
0000000A00