0000000A00
0000011111
0000000100
0000011111
0000000000
0000000000
2220000333
0200000030
2220000333
0B000000C0