0000C00000
0003330000
0000300000
0003330000
0000000000
0000000000
0000000000
0202001010
0222B0111A
0202001010